S####......#........
....#......#........
....#......#........
#####.....#.......##
......###........#..
..####...........#..
##................##
....................
...##.##..##....#...
.#..............#...
.#....#.#.#.....#...
.....#.....#.....#..
.#...#.....#......#.
.#...#....#......#..
.#..#.....#.....#...
..##.......#.....#..
...........#......#.
............#....#..
............#.......
...........#........