S###.......##.###...
...#..###...........
...###...##..#...###
...................#
#..................#
##..................
..#.....##....##....
..#...##....##..#...
....##....##....#...
................#...
..########......#...
.#....####......#...
.#...#..........#...
.#...#..........#...
.#....##########....
.#..................
.#.....###..........
..#####...###.......
.............###....
....................