S##########.....................
..........#.....................
..........#.....................
..........#.....................
..........#....#................
####......#..............#######
...#......#.............#.......
...#......#...#.........#.......
...#......#.#...........#.......
...#......#.............#.......
...########.............#.......
...........#.......#####........
..............#...#.............
..................#.............
...............#..#.............
............#.....#.............
..................#.............
...........#......#.............
........#.......................
................................
..................#.............
.......#..........#.............
.....#............#.............
..................#.............
....#.............#.............
....#.............#.............
....#...........................
....#..####.######..............
................................
................................
................................
................................